1111111111
1P001C0001
1000000001
1000110001
100EE00001
1000111101
1000000001
1C00001111
10000000C1
1111111111