1111111111
1P000C0001
1000000001
1000111101
1000E00001
1000111101
1000000001
1C00000001
1000000001
1111111111