11111111111111111111
1P001C0000011C1110C1
10000000010000100001
10001100011111100011
1000E000001100C00101
10001111011000000011
10000000011000111001
1C000011100001100001
10000000C00000111C11
11111111111111111111