111111111111111111111111111111111111111111111111111111111111
1P001C000100000000000000111111111111111000000000001111C00111
100000000000011000100000000000000000000000000000011100000111
10001100010000000100011110100000000E111111111000000000001111
1000000010001111010000000010000C0001111111111111111000001111
100011110100000000100000000100000001100000000000C11000000111
100000000100000000100000001001111011111111111000000000001111
1C00001111000000000000000C1000000000000000000000000000001111
10000000C000000000111111111111111111111111111C11111111111111
111111111111111111111111111111111111111111111111111111111111