111111111111111111111111111111111111111
1P001C000100000000000000111111111111111
100000000000011000100000000000000000001
10001100010000000100011110100000000E111
1000000010001111010000000010000C0001111
100011110100000000100000000100000001111
100000000100000000100000001001111011111
1C00001111000000000000000C1000000000001
10000000C000000000111111111111111111111
111111111111111111111111111111111111111